"filename", "language", "HTML", "PostCSS", "JavaScript", "comment", "blank", "total"
"c:\Users\fquin\Documents\appweb\FRONTEND\CSS\barraLateral.css", "PostCSS", 0, 101, 0, 1, 16, 118
"c:\Users\fquin\Documents\appweb\FRONTEND\CSS\login.css", "PostCSS", 0, 36, 0, 0, 5, 41
"c:\Users\fquin\Documents\appweb\FRONTEND\CSS\main.css", "PostCSS", 0, 16, 0, 0, 5, 21
"c:\Users\fquin\Documents\appweb\FRONTEND\CSS\stylesDomiciliario.css", "PostCSS", 0, 447, 0, 8, 75, 530
"c:\Users\fquin\Documents\appweb\FRONTEND\CSS\stylesTienda.css", "PostCSS", 0, 424, 0, 9, 76, 509
"c:\Users\fquin\Documents\appweb\FRONTEND\CSS\stylessGestion.css", "PostCSS", 0, 419, 0, 7, 66, 492
"c:\Users\fquin\Documents\appweb\FRONTEND\JS\auth.js", "JavaScript", 0, 0, 10, 0, 1, 11
"c:\Users\fquin\Documents\appweb\FRONTEND\JS\datosGlobales.js", "JavaScript", 0, 0, 89, 10, 17, 116
"c:\Users\fquin\Documents\appweb\FRONTEND\JS\estadoGlobal.js", "JavaScript", 0, 0, 108, 9, 20, 137
"c:\Users\fquin\Documents\appweb\FRONTEND\JS\login.js", "JavaScript", 0, 0, 86, 10, 21, 117
"c:\Users\fquin\Documents\appweb\FRONTEND\JS\router.js", "JavaScript", 0, 0, 27, 0, 4, 31
"c:\Users\fquin\Documents\appweb\FRONTEND\JS\scriptTienda.js", "JavaScript", 0, 0, 277, 53, 57, 387
"c:\Users\fquin\Documents\appweb\FRONTEND\JS\scriptsDomiciliario.js", "JavaScript", 0, 0, 250, 46, 49, 345
"c:\Users\fquin\Documents\appweb\FRONTEND\JS\scriptsGestion.js", "JavaScript", 0, 0, 262, 37, 46, 345
"c:\Users\fquin\Documents\appweb\FRONTEND\JS\sistemaEventos.js", "JavaScript", 0, 0, 36, 7, 6, 49
"c:\Users\fquin\Documents\appweb\FRONTEND\index.html", "HTML", 61, 0, 0, 0, 7, 68
"c:\Users\fquin\Documents\appweb\FRONTEND\indexDomiciliario.html", "HTML", 158, 0, 0, 4, 4, 166
"c:\Users\fquin\Documents\appweb\FRONTEND\indexGestion.html", "HTML", 165, 0, 0, 4, 5, 174
"c:\Users\fquin\Documents\appweb\FRONTEND\indexTienda.html", "HTML", 132, 0, 0, 6, 7, 145
"c:\Users\fquin\Documents\appweb\FRONTEND\login.html", "HTML", 42, 0, 0, 3, 2, 47
"c:\Users\fquin\Documents\appweb\FRONTEND\modules\Proveedores\proveedores.css", "PostCSS", 0, 401, 0, 14, 66, 481
"c:\Users\fquin\Documents\appweb\FRONTEND\modules\Proveedores\proveedores.html", "HTML", 112, 0, 0, 1, 4, 117
"c:\Users\fquin\Documents\appweb\FRONTEND\modules\Proveedores\proveedores.js", "JavaScript", 0, 0, 316, 60, 83, 459
"c:\Users\fquin\Documents\appweb\FRONTEND\modules\Usuarios\Usuarios.css", "PostCSS", 0, 278, 0, 0, 44, 322
"c:\Users\fquin\Documents\appweb\FRONTEND\modules\Usuarios\Usuarios.html", "HTML", 102, 0, 0, 5, 4, 111
"c:\Users\fquin\Documents\appweb\FRONTEND\modules\Usuarios\Usuarios.js", "JavaScript", 0, 0, 178, 20, 50, 248
"c:\Users\fquin\Documents\appweb\FRONTEND\modules\carrito\carrito.css", "PostCSS", 0, 161, 0, 1, 27, 189
"c:\Users\fquin\Documents\appweb\FRONTEND\modules\carrito\carrito.html", "HTML", 42, 0, 0, 1, 1, 44
"c:\Users\fquin\Documents\appweb\FRONTEND\modules\carrito\carrito.js", "JavaScript", 0, 0, 208, 21, 37, 266
"c:\Users\fquin\Documents\appweb\FRONTEND\modules\catalogo\catalogo.css", "PostCSS", 0, 137, 0, 47, 18, 202
"c:\Users\fquin\Documents\appweb\FRONTEND\modules\catalogo\catalogo.html", "HTML", 17, 0, 0, 2, 0, 19
"c:\Users\fquin\Documents\appweb\FRONTEND\modules\catalogo\catalogo.js", "JavaScript", 0, 0, 132, 39, 30, 201
"c:\Users\fquin\Documents\appweb\FRONTEND\modules\compras\compras.css", "PostCSS", 0, 567, 0, 18, 104, 689
"c:\Users\fquin\Documents\appweb\FRONTEND\modules\compras\compras.html", "HTML", 168, 0, 0, 9, 18, 195
"c:\Users\fquin\Documents\appweb\FRONTEND\modules\compras\compras.js", "JavaScript", 0, 0, 716, 92, 142, 950
"c:\Users\fquin\Documents\appweb\FRONTEND\modules\dashboard\dashboard.css", "PostCSS", 0, 67, 0, 1, 13, 81
"c:\Users\fquin\Documents\appweb\FRONTEND\modules\dashboard\dashboard.html", "HTML", 103, 0, 0, 1, 2, 106
"c:\Users\fquin\Documents\appweb\FRONTEND\modules\dashboard\dashboard.js", "JavaScript", 0, 0, 74, 3, 10, 87
"c:\Users\fquin\Documents\appweb\FRONTEND\modules\facturas\facturas.css", "PostCSS", 0, 268, 0, 26, 44, 338
"c:\Users\fquin\Documents\appweb\FRONTEND\modules\facturas\facturas.html", "HTML", 55, 0, 0, 5, 11, 71
"c:\Users\fquin\Documents\appweb\FRONTEND\modules\facturas\facturas.js", "JavaScript", 0, 0, 130, 10, 19, 159
"c:\Users\fquin\Documents\appweb\FRONTEND\modules\favoritos\favoritos.css", "PostCSS", 0, 64, 0, 0, 14, 78
"c:\Users\fquin\Documents\appweb\FRONTEND\modules\favoritos\favoritos.html", "HTML", 15, 0, 0, 0, 2, 17
"c:\Users\fquin\Documents\appweb\FRONTEND\modules\favoritos\favoritos.js", "JavaScript", 0, 0, 99, 2, 15, 116
"c:\Users\fquin\Documents\appweb\FRONTEND\modules\gestion-pagos-entregas\gestion-pagos-entregas.css", "PostCSS", 0, 197, 0, 1, 35, 233
"c:\Users\fquin\Documents\appweb\FRONTEND\modules\gestion-pagos-entregas\gestion-pagos-entregas.html", "HTML", 74, 0, 0, 1, 9, 84
"c:\Users\fquin\Documents\appweb\FRONTEND\modules\gestion-pagos-entregas\gestion-pagos-entregas.js", "JavaScript", 0, 0, 167, 1, 25, 193
"c:\Users\fquin\Documents\appweb\FRONTEND\modules\historial-entregas\historial-entregas.css", "PostCSS", 0, 174, 0, 1, 30, 205
"c:\Users\fquin\Documents\appweb\FRONTEND\modules\historial-entregas\historial-entregas.html", "HTML", 50, 0, 0, 3, 1, 54
"c:\Users\fquin\Documents\appweb\FRONTEND\modules\historial-entregas\historial-entregas.js", "JavaScript", 0, 0, 150, 0, 25, 175
"c:\Users\fquin\Documents\appweb\FRONTEND\modules\mapa-rutas\mapa-rutas.css", "PostCSS", 0, 135, 0, 2, 27, 164
"c:\Users\fquin\Documents\appweb\FRONTEND\modules\mapa-rutas\mapa-rutas.html", "HTML", 25, 0, 0, 1, 0, 26
"c:\Users\fquin\Documents\appweb\FRONTEND\modules\mapa-rutas\mapa-rutas.js", "JavaScript", 0, 0, 115, 1, 20, 136
"c:\Users\fquin\Documents\appweb\FRONTEND\modules\pedidos-asignados\pedidos-asignados.css", "PostCSS", 0, 350, 0, 11, 56, 417
"c:\Users\fquin\Documents\appweb\FRONTEND\modules\pedidos-asignados\pedidos-asignados.html", "HTML", 83, 0, 0, 5, 8, 96
"c:\Users\fquin\Documents\appweb\FRONTEND\modules\pedidos-asignados\pedidos-asignados.js", "JavaScript", 0, 0, 415, 84, 92, 591
"c:\Users\fquin\Documents\appweb\FRONTEND\modules\pedidos\pedidos.css", "PostCSS", 0, 134, 0, 5, 24, 163
"c:\Users\fquin\Documents\appweb\FRONTEND\modules\pedidos\pedidos.html", "HTML", 46, 0, 0, 4, 8, 58
"c:\Users\fquin\Documents\appweb\FRONTEND\modules\pedidos\pedidos.js", "JavaScript", 0, 0, 133, 9, 20, 162
"c:\Users\fquin\Documents\appweb\FRONTEND\modules\perfil-Domiciliario\perfil-Domiciliario.css", "PostCSS", 0, 108, 0, 0, 21, 129
"c:\Users\fquin\Documents\appweb\FRONTEND\modules\perfil-Domiciliario\perfil-Domiciliario.html", "HTML", 43, 0, 0, 0, 3, 46
"c:\Users\fquin\Documents\appweb\FRONTEND\modules\perfil-Domiciliario\perfil-Domiciliario.js", "JavaScript", 0, 0, 85, 3, 12, 100
"c:\Users\fquin\Documents\appweb\FRONTEND\modules\productos\productos.css", "PostCSS", 0, 411, 0, 15, 69, 495
"c:\Users\fquin\Documents\appweb\FRONTEND\modules\productos\productos.html", "HTML", 127, 0, 0, 7, 11, 145
"c:\Users\fquin\Documents\appweb\FRONTEND\modules\productos\productos.js", "JavaScript", 0, 0, 378, 63, 85, 526
"c:\Users\fquin\Documents\appweb\FRONTEND\modules\ruta-entrega\ruta-entrega.css", "PostCSS", 0, 13, 0, 0, 2, 15
"c:\Users\fquin\Documents\appweb\FRONTEND\modules\ruta-entrega\ruta-entrega.html", "HTML", 12, 0, 0, 1, 0, 13
"c:\Users\fquin\Documents\appweb\FRONTEND\modules\ruta-entrega\ruta-entrega.js", "JavaScript", 0, 0, 84, 0, 19, 103
"c:\Users\fquin\Documents\appweb\FRONTEND\modules\stock\stock.css", "PostCSS", 0, 206, 0, 2, 42, 250
"c:\Users\fquin\Documents\appweb\FRONTEND\modules\stock\stock.html", "HTML", 64, 0, 0, 1, 11, 76
"c:\Users\fquin\Documents\appweb\FRONTEND\modules\stock\stock.js", "JavaScript", 0, 0, 131, 12, 25, 168
"c:\Users\fquin\Documents\appweb\FRONTEND\modules\usuario\usuario.css", "PostCSS", 0, 175, 0, 10, 37, 222
"c:\Users\fquin\Documents\appweb\FRONTEND\modules\usuario\usuario.html", "HTML", 133, 0, 0, 4, 5, 142
"c:\Users\fquin\Documents\appweb\FRONTEND\modules\usuario\usuario.js", "JavaScript", 0, 0, 175, 2, 30, 207
"c:\Users\fquin\Documents\appweb\FRONTEND\modules\ventas\ventas.css", "PostCSS", 0, 489, 0, 18, 81, 588
"c:\Users\fquin\Documents\appweb\FRONTEND\modules\ventas\ventas.html", "HTML", 129, 0, 0, 7, 7, 143
"c:\Users\fquin\Documents\appweb\FRONTEND\modules\ventas\ventas.js", "JavaScript", 0, 0, 447, 65, 94, 606
"c:\Users\fquin\Documents\appweb\FRONTEND\prueba.html", "HTML", 43, 0, 0, 0, 6, 49
"Total", "-", 2001, 5778, 5278, 931, 2187, 16175